NO ./img/north
SO ./img/south
WE ./img/west
EA ./img/east

S ./img/sprite
F 220,100,0
C 225,30,0

        1111111111111111111111111111111111111
        1000000000000010000000000000100000001
        1000000000000010000000000011110000001
        1111100000001111100000000011110000001
        1111100000000000000000000000000000001
        1000000001111111111111111111111000001
111111111000000000000011100000000001100000001
100000000000000000000000000000200000100000001
100000000000000000000011100000000001100000001
100000000000000001111111111111111111111000001
1111111100111111111111              111111111
       1001
       1001
    1111001111
    1000000001
    1000N00001
    1000000001
    1111111111  
