11111111
10000001
10000001
10000111
10000001
10000011
11000001
11111111
